que aso wey
todo correcto
y yo que
me alegro
yepa
ya estoy
por
quie
alegro

ajdf

ghhjk

ffs

1122333321111111

1111111111111111