NO ./ruta_a_la_textura_norte

F 220,100,0

SO ./ruta_a_la_textura_sur
WE ./ruta_a_la_textura_oeste
C 225,30,0





EA ./ruta_a_la_textura_este
    1111111111111111111111111
1000000000110000000000001
1011000001110000000000001
100100000000000000000000111111111
111111111011000001110000000000001
100000000011000001110111111111111
11110111111111011100000010001
11110111111111011101010010001
11000001101010111000000000001
10000000000000001100000010001
1111111111111111111011111111
1100000111010111101111N0011
11110111 1110101 101111010001
11111111 1111111 111111111111
