NO ./ruta_a_la_textura_norte

F 220,100,0

SO ./ruta_a_la_textura_sur
WE ./ruta_a_la_textura_oeste
C 225,30,0





EA ./ruta_a_la_textura_este
1111111111111111111111111
1000000000000000000000001
1000000000000000000000001
1000000000000000000000001
100000S000000000000000001
1000000000000000000000001
1000000000000000000000001
1111111111111111111111111
