NO ./test/test_xpm/bricks.xpm

F 220,100,0

SO ./test/test_xpm/bookshelf.xpm
WE ./test/test_xpm/gemov2.xpm
C 225,30,0





EA ./test/test_xpm/tilledsoil.xpm
1111111111111111111111111
1000000000000000000000001
1000000000001010000000001
1000000000000000000000001
100E000000000100000000001
1000000000001010000000001
1000000000000000000000001
1000000000000001110000001
1000001100000001110000001
1000001100000000000000001
1000000000000001111000001
1000000001000000000000001
1000000000000000000000001
1000000000000001000000001
1000000011000000000000001
1000001111000000000000001
1000000000000000000000001
1000000000000000000000001
1111111111111111111111111
